//MAP CONVERTED BY dmm2tgm.py THIS HEADER COMMENT PREVENTS RECONVERSION, DO NOT REMOVE
"a" = (
/turf/closed/mineral/random/rogue/high,
/area/rogue)
"b" = (
/mob/living/carbon/human/species/hobgoblin/npc,
/turf/open/floor/rogue/naturalstone,
/area/rogue)
"c" = (
/obj/structure/ladder/earth,
/obj/structure/ladder/earth,
/turf/open/floor/rogue/dirt,
/area/rogue)
"d" = (
/turf/closed/wall/mineral/rogue/tent{
	dir = 4
	},
/area/rogue)
"e" = (
/obj/effect/spawner/lootdrop/general_loot_mid/x3,
/obj/structure/closet/crate/chest/wicker,
/turf/open/floor/rogue/dirt/road,
/area/rogue)
"f" = (
/obj/structure/flora/roguegrass/water,
/turf/open/floor/rogue/dirt,
/area/rogue)
"h" = (
/obj/machinery/light/rogue/torchholder/c,
/turf/open/floor/rogue/dirt,
/area/rogue)
"i" = (
/obj/machinery/light/rogue/campfire/longlived,
/turf/open/floor/rogue/dirt,
/area/rogue)
"j" = (
/turf/closed/wall/mineral/rogue/tent{
	dir = 8
	},
/area/rogue)
"l" = (
/mob/living/carbon/human/species/goblin/npc,
/obj/structure/bed/rogue/shit,
/turf/open/floor/rogue/naturalstone,
/area/rogue)
"n" = (
/obj/structure/flora/roguegrass/water,
/turf/open/water/swamp,
/area/rogue)
"o" = (
/obj/machinery/light/rogue/torchholder/l,
/turf/open/floor/rogue/naturalstone,
/area/rogue)
"p" = (
/obj/structure/bed/rogue/shit,
/turf/open/floor/rogue/dirt/road,
/area/rogue)
"q" = (
/obj/structure/chair/stool/rogue,
/turf/open/floor/rogue/dirt,
/area/rogue)
"s" = (
/obj/machinery/light/rogue/torchholder/r,
/turf/open/floor/rogue/dirt,
/area/rogue)
"t" = (
/mob/living/carbon/human/species/goblin/npc,
/obj/structure/bed/rogue/shit,
/turf/open/floor/rogue/dirt,
/area/rogue)
"u" = (
/turf/closed/mineral/rogue/bedrock,
/area/rogue)
"w" = (
/turf/open/floor/rogue/dirt,
/area/rogue)
"x" = (
/mob/living/carbon/human/species/goblin/npc,
/turf/open/floor/rogue/naturalstone,
/area/rogue)
"y" = (
/obj/structure/roguetent,
/turf/open/floor/rogue/dirt/road,
/area/rogue)
"z" = (
/turf/open/transparent/openspace,
/area/rogue)
"A" = (
/mob/living/carbon/human/species/goblin/npc,
/turf/open/floor/rogue/dirt,
/area/rogue)
"B" = (
/obj/machinery/light/rogue/torchholder/l,
/turf/open/water/swamp,
/area/rogue)
"C" = (
/obj/effect/dungeon_directional_helper/west,
/turf/open/floor/rogue/naturalstone,
/area/rogue)
"D" = (
/turf/open/water/swamp,
/area/rogue)
"F" = (
/mob/living/carbon/human/species/hobgoblin/npc,
/turf/open/floor/rogue/dirt,
/area/rogue)
"G" = (
/obj/effect/dungeon_directional_helper/south,
/turf/open/floor/rogue/naturalstone,
/area/rogue)
"H" = (
/turf/closed/wall/mineral/rogue/wood,
/area/rogue)
"I" = (
/obj/structure/roguetent,
/turf/open/floor/rogue/dirt,
/area/rogue)
"J" = (
/obj/machinery/light/rogue/torchholder/r,
/turf/open/floor/rogue/naturalstone,
/area/rogue)
"K" = (
/turf/closed/wall/mineral/rogue/tent,
/area/rogue)
"L" = (
/obj/structure/ladder/earth,
/turf/open/floor/rogue/dirt,
/area/rogue)
"M" = (
/obj/machinery/light/rogue/torchholder/c,
/turf/open/floor/rogue/naturalstone,
/area/rogue)
"N" = (
/mob/living/carbon/human/species/goblin/npc,
/turf/open/floor/rogue/dirt/road,
/area/rogue)
"O" = (
/obj/effect/spawner/lootdrop/general_loot_low/x3,
/obj/structure/closet/crate/chest/wicker,
/turf/open/floor/rogue/dirt/road,
/area/rogue)
"P" = (
/turf/open/floor/rogue/naturalstone,
/area/rogue)
"Q" = (
/obj/machinery/light/rogue/torchholder/l,
/turf/open/floor/rogue/dirt,
/area/rogue)
"R" = (
/turf/closed/wall/mineral/rogue/tent{
	dir = 1
	},
/area/rogue)
"S" = (
/obj/item/reagent_containers/food/snacks/rogue/meat/sausage{
	pixel_x = 6;
	pixel_y = 4
	},
/obj/item/grown/log/tree/stake,
/turf/open/floor/rogue/dirt,
/area/rogue)
"T" = (
/obj/effect/dungeon_directional_helper/north,
/turf/open/floor/rogue/naturalstone,
/area/rogue)
"U" = (
/obj/structure/roguetent,
/turf/open/floor/rogue/naturalstone,
/area/rogue)
"X" = (
/turf/open/floor/rogue/dirt/road,
/area/rogue)
"Y" = (
/mob/living/carbon/human/species/hobgoblin/npc,
/turf/open/floor/rogue/dirt/road,
/area/rogue)
"Z" = (
/obj/effect/dungeon_directional_helper/east,
/turf/open/floor/rogue/naturalstone,
/area/rogue)

(1,1,1) = {"
u
u
u
u
u
u
u
u
u
u
u
P
C
P
u
u
u
u
u
u
u
u
u
u
"}
(2,1,1) = {"
u
a
a
a
a
a
a
a
a
a
a
a
P
a
a
a
a
a
a
a
a
a
a
u
"}
(3,1,1) = {"
u
a
a
a
a
D
D
D
D
a
P
P
P
a
a
D
D
D
a
a
a
a
a
u
"}
(4,1,1) = {"
u
a
a
a
D
D
P
P
P
P
P
a
P
a
a
D
D
D
D
a
a
a
a
u
"}
(5,1,1) = {"
u
a
a
w
a
P
H
d
d
d
d
H
P
o
P
w
P
f
D
a
a
a
a
u
"}
(6,1,1) = {"
u
a
a
D
P
P
K
e
p
X
N
R
P
P
P
a
P
a
D
B
a
a
a
u
"}
(7,1,1) = {"
u
a
a
n
a
a
K
X
X
Y
X
y
w
a
w
P
P
P
w
w
D
a
a
u
"}
(8,1,1) = {"
u
a
a
D
w
a
K
p
N
X
X
y
w
w
S
w
w
x
P
f
w
D
a
u
"}
(9,1,1) = {"
u
a
a
a
w
a
K
X
X
O
X
R
w
i
q
w
a
P
P
a
w
a
a
u
"}
(10,1,1) = {"
u
a
D
D
f
w
H
j
j
j
j
H
w
S
w
w
f
P
P
P
P
P
P
u
"}
(11,1,1) = {"
P
a
a
a
w
w
w
b
P
P
P
a
a
h
D
w
P
b
P
P
P
a
M
P
"}
(12,1,1) = {"
T
P
P
P
P
P
P
P
a
P
P
a
L
w
D
a
P
a
P
P
P
P
P
G
"}
(13,1,1) = {"
P
a
a
w
w
w
a
P
P
P
P
a
w
a
P
w
f
P
P
a
P
P
P
P
"}
(14,1,1) = {"
u
a
a
n
w
s
w
P
w
P
P
w
w
w
a
w
w
J
P
P
P
P
P
u
"}
(15,1,1) = {"
u
a
a
a
w
a
f
P
H
d
y
H
w
w
S
w
w
a
P
A
w
a
P
u
"}
(16,1,1) = {"
u
a
a
a
D
a
w
a
K
p
X
R
w
q
i
a
w
w
w
w
f
D
a
u
"}
(17,1,1) = {"
u
a
a
a
a
D
w
w
K
O
Y
R
w
f
q
w
f
a
a
w
D
a
a
u
"}
(18,1,1) = {"
u
a
a
a
a
D
D
a
H
j
j
H
w
w
a
D
D
P
a
w
D
a
a
u
"}
(19,1,1) = {"
u
a
a
a
a
a
D
D
a
w
P
P
P
w
D
a
a
w
H
y
d
H
a
u
"}
(20,1,1) = {"
u
a
a
a
a
a
a
D
w
f
w
a
P
a
a
a
a
D
K
X
O
R
a
u
"}
(21,1,1) = {"
u
a
a
a
a
a
a
a
a
a
D
a
P
a
a
a
a
a
K
N
p
R
a
u
"}
(22,1,1) = {"
u
a
a
a
a
a
a
a
a
a
a
a
P
a
a
a
a
a
H
j
j
H
a
u
"}
(23,1,1) = {"
u
a
a
a
a
a
a
a
a
a
a
a
P
a
a
a
a
a
a
a
a
a
a
u
"}
(24,1,1) = {"
u
u
u
u
u
u
u
u
u
u
u
P
Z
P
u
u
u
u
u
u
u
u
u
u
"}

(1,1,2) = {"
u
u
u
u
u
u
u
u
u
u
u
P
P
w
u
u
u
u
u
u
u
u
u
u
"}
(2,1,2) = {"
u
a
a
a
a
a
a
a
a
a
a
P
P
P
a
a
a
a
a
a
a
a
a
u
"}
(3,1,2) = {"
u
a
a
a
a
a
a
a
a
a
a
P
P
P
Q
D
D
a
a
a
a
a
a
u
"}
(4,1,2) = {"
u
a
a
a
a
a
D
D
D
a
a
w
a
P
w
w
D
D
a
a
a
a
a
u
"}
(5,1,2) = {"
u
a
a
a
a
a
D
w
w
w
w
P
w
P
w
w
D
a
a
a
a
a
a
u
"}
(6,1,2) = {"
u
a
a
a
a
B
w
w
a
a
h
P
x
P
a
H
d
d
d
H
a
a
a
u
"}
(7,1,2) = {"
u
a
a
a
a
P
w
P
P
P
w
w
w
P
w
K
P
P
F
R
D
a
a
u
"}
(8,1,2) = {"
u
a
a
a
a
P
P
H
d
d
H
w
w
F
P
U
w
a
P
R
D
D
a
u
"}
(9,1,2) = {"
u
a
a
a
a
D
w
K
t
w
R
w
i
w
w
K
w
w
l
R
D
D
a
u
"}
(10,1,2) = {"
z
a
a
a
a
D
w
K
w
w
I
w
w
w
w
H
j
j
j
H
P
P
w
u
"}
(11,1,2) = {"
w
w
a
a
a
D
w
H
j
j
H
w
w
a
D
P
P
w
w
a
a
P
P
P
"}
(12,1,2) = {"
P
w
w
w
a
D
w
P
P
P
P
a
c
w
P
w
a
P
w
a
w
P
P
P
"}
(13,1,2) = {"
P
P
a
w
w
a
w
P
P
P
P
a
a
P
w
D
a
P
P
P
J
P
P
w
"}
(14,1,2) = {"
z
P
J
P
P
w
w
P
a
P
P
a
o
P
P
P
P
P
P
P
a
w
a
u
"}
(15,1,2) = {"
u
a
a
w
P
P
P
P
A
w
w
w
w
w
A
P
a
w
w
P
w
D
a
u
"}
(16,1,2) = {"
u
a
a
a
w
w
P
P
P
w
a
w
w
w
a
P
w
w
w
D
a
a
a
u
"}
(17,1,2) = {"
u
a
a
a
a
D
D
D
P
P
b
w
a
w
P
P
w
w
D
a
a
a
a
u
"}
(18,1,2) = {"
u
a
a
a
a
a
a
D
D
P
P
P
w
w
P
P
s
D
a
a
a
a
a
u
"}
(19,1,2) = {"
u
a
a
a
a
a
a
a
a
D
P
P
w
a
P
a
a
a
a
a
a
a
a
u
"}
(20,1,2) = {"
u
a
a
a
a
a
a
a
a
D
D
P
w
P
P
a
a
a
a
a
a
a
a
u
"}
(21,1,2) = {"
u
a
a
a
a
a
a
a
a
a
w
P
a
P
w
a
a
a
a
a
a
a
a
u
"}
(22,1,2) = {"
u
a
a
a
a
a
a
a
a
a
J
P
P
P
a
a
a
a
a
a
a
a
a
u
"}
(23,1,2) = {"
u
a
a
a
a
a
a
a
a
a
a
P
P
P
a
a
a
a
a
a
a
a
a
u
"}
(24,1,2) = {"
u
u
u
u
u
u
u
u
u
u
u
w
P
P
u
u
u
u
u
u
u
u
u
u
"}
